M-Van_der_Pauw_elem1-Mode	IV
M-Van_der_Pauw_elem1-Nb_Point_IV	5
M-Van_der_Pauw_elem1-Time_Avant_Mesure	0.0
M-Van_der_Pauw_elem1-Current_Max	1e-3
M-Van_der_Pauw_elem1-Tension_Max	1e-5
M-Van_der_Pauw_elem1-Plot_IV	False
M-Van_der_Pauw_elem1-Position_Switch_A	1
M-Van_der_Pauw_elem1-Position_Switch_B	2
M-Van_der_Pauw_elem1-Position_Switch_C	3
M-Van_der_Pauw_elem1-Position_Switch_D	4
M-Van_der_Pauw_elem1-Debbug_IV	True

M-Van_der_Pauw_elem2-Mode	IV
M-Van_der_Pauw_elem1-Nb_Point_IV	5
M-Van_der_Pauw_elem1-Time_Avant_Mesure	0.0
M-Van_der_Pauw_elem2-Current_Max	1e-3
M-Van_der_Pauw_elem2-Tension_Max	1e-5
M-Van_der_Pauw_elem2-Plot_IV	False
M-Van_der_Pauw_elem2-Position_Switch_A	1
M-Van_der_Pauw_elem2-Position_Switch_B	2
M-Van_der_Pauw_elem2-Position_Switch_C	3
M-Van_der_Pauw_elem2-Position_Switch_D	4
M-Van_der_Pauw_elem2-Debbug_IV	True

I-Switch-Position_Switch_Current_HI	1
I-Switch-Position_Switch_Current_LO	2
I-Switch-Position_Switch_Voltage_HI	1
I-Switch-Position_Switch_Voltage_LO	2
I-Source-Voltage_Max	1
I-Source-Number_Wire	4

C-Min_Entre_Prise	10
